222222222222222222222222
611111111111111111111114
611111111111111111111114
611111111111111111111114
611111111111111111111114
611111111111111111111114
611111111111111111111114
611111111111111111111114
611111111111111111111114
611111111111111111111114
611111111111111111111114
611111111111111111111114
611111111111111111111114
611111111111111111111114
611111111111111111111114
611111111111111111111114
611111111111111111111114
611111111111111111111114
611111111111111111111114
611111111111111111111114
611111111111111111111114
611111111111111111111114
611111111111111111111114
888888888888888888888888