22222222222222222222
61111111111111111114
61111111111111111114
61111111111111111114
61111111111111111114
61111111111111111114
61111111111111111114
61111111111111111114
61111111111111111114
61111111111111111114
61111111111111111114
61111111111111111114
61111111111111111114
61111111111111111114
61111111111111111114
61111111111111111114
61111111111111111114
61111111111111111114
61111111111111111114
88888888888888888888