11111111111111111111
10000030300030300001
10000030300030300001
10000030300030300001
10000030300030300001
10000030300030300001
10000030300030300001
10000030300030300001
10000030300030300001
10000030300030300001
10000030300030300001
10000030300030300001
10000030300030300001
10003030303030300001
10000030300030300001
10000030300030300001
10000030300030300001
10000030300030300001
10000030300030300001
11111111111111111111